n = 3

1hhhhhhhhhhhhhhhhhhhh2
g____________________d
g____________________d
g____________________d
g____________________d
g____________________d
g____________________d
g____________________d
g____________________d
g____________________d
g____________________d
g____________________d
g____________________d
g____________________d
g____________________d
g____________________d
g____________________d
g____________________d
g____________________d
g____________________d
g____________________d
3bbbbbbbbbbbbbbbbbbbb4
1hhhhhhhhhhhhhhhhhhhh2
g____________________d
g____________________d
g____________________d
g____________________d
g____________________d
g_____h______________d
g_____h______________d
g_____h________h_____d
g_____h________h_____d
g_____h________h_____d
g_____h________h_____d
g_____h________hh____d
g____________________d
g____________________d
g____________________d
g____________________d
g____________________d
g____________________d
g____________________d
g____________________d
3bbbbbbbbbbbbbbbbbbbb4
1hhhhhhhhhhhhhhhhhhhh2
g____________________d
g____________________d
g____________________d
g____________________d
g____________________d
g____________________d
g____________________d
g_________h__________d
g____h_______________d
g______h____h________d
g____________________d
g____________________d
g______h____h________d
g____________________d
g____________________d
g____________________d
g____________________d
g____________________d
g____________________d
g____________________d
3bbbbbbbbbbbbbbbbbbbb4
